^^^^^^^^^^^^^^^^^^^^^^^^^^^^^^^^^^^^^^^^^^^^^^^^^^^^^^^^^^^^^^^^
^^^^^^^^^^^^^^^^^^^^^^^^^^^^^^^^^^^^^^^^^^^^^^^^^^^^^^^^^^^^^^^^
^^^^^^^^^^^^^^^^^^^^^^^^^^^^^^^^^^^^^^^^^^^^^^^^^^^^^^^^^^^^^^^^
^^^           ^                                              ^^^
^^^^^   ^ ^^  ^   ^  ^^^^^^^ ^^^^^^^    ^^^^^^^^^^^     ^^^  ^^^
^^^ ^^^^^^^^  ^^^^^  ^    ^      ^ ^                    ^ ^  ^^^
^^^                  ^    ^      ^ ^^^^^^^^^^^^^^^^^    ^ ^  ^^^
^^^^^^^^^^^^^^^^^^^^^^    ^      ^                     ^^ ^  ^^^
^^^                                                       ^  ^^^
^^^  ^^ ^^^ ^^^ ^^^^ ^^^^^^ ^^^^^^^^ ^^^^^^^^^^^^^^^^  ^  ^  ^^^
^^^  ^^ ^^    ^ ^      ^    ^                          ^  ^  ^^^
^^^  ^^       ^ ^ ^^^^ ^    ^      ^                   ^  ^  ^^^
^^^  ^^^^^ ^^^^ ^^^  ^ ^^^^^^^^  ^^^^^^^^^^^^^^^^^^ ^^ ^  ^  ^^^
^^^  ^        ^            ^^^^      ^   ^   ^   ^     ^  ^  ^^^
^^^  ^ ^^^^^^^^              ^^        ^   ^   ^    ^  ^  ^  ^^^
^^^  ^      ^^^ ^^^^ ^^^^^^ ^^^^^^^^ ^^^^^^^^^^^^^^^^  ^  ^  ^^^
^^^  ^^ ^^    ^ ^      ^    ^                          ^  ^  ^^^
^^^           ^ ^ ^^^^ ^    ^      ^                      ^  ^^^
^^^  ^^ ^^^^^ ^ ^^^  ^ ^^^^^^^^ ^^^^^^^^^^^^^^^^^^^ ^^^   ^  ^^^
^^^  ^        ^      ^       ^^ ^^                      ^^^^^^^^
^^^  ^ ^^^^ ^^^      ^       ^^ ^^         ^ ^ ^ ^ ^ ^    ^  ^^^
^^^    ^^^   ^^^     ^           ^         ^ ^       ^   ^   ^^^
^^^    ^^     ^^     ^        ^^^^^^^^^^^^^^^^  ^    ^  ^    ^^^
^^^                  ^        ^           ^^   ^     ^ ^     ^^^
^^^  ^^ ^^^^^^^^^^^^^^^^^^^^^^^  ^^  ^^^^^^^      ^ ^  ^ ^   ^^^
^^^   ^  ^         ^   ^    ^  ^ ^ ^  ^   ^   ^^ ^^  ^   ^   ^^^
^^^ ^^^^ ^ ^   ^   ^^ ^^    ^  ^ ^  ^ ^   ^    ^  ^  ^   ^   ^^^
^^^    ^   ^  ^^^                ^    ^    ^^^^^^^^^^^^^^    ^^^
^^^                                                          ^^^
^^^^^^^^^^^^^^^^^^^^^^^^^^^^^^^^^^^^^^^^^^^^^^^^^^^^^^^^^^^^^^^^
^^^^^^^^^^^^^^^^^^^^^^^^^^^^^^^^^^^^^^^^^^^^^^^^^^^^^^^^^^^^^^^^
^^^^^^^^^^^^^^^^^^^^^^^^^^^^^^^^^^^^^^^^^^^^^^^^^^^^^^^^^^^^^^^^