^^^^^^^^^^^^^^^^^^^^^^^^^^^^^^^^^^^^^^^^^^^^^^^^^^^^^^^^^^^^^^^^
^^^^^^^^^^^^^^^^^^^^^^^^^^^^^^^^^^^^^^^^^^^^^^^^^^^^^^^^^^^^^^^^
^^^^^^^^^^^^^^^^^^^^^^^^^^^^^^^^^^^^^^^^^^^^^^^^^^^^^^^^^^^^^^^^
^^^           ^   #                                          ^^^
^^^^^   ^ ^^  ^   ^  ^^^^^^^ ^^^^^^^    ^^^^^^^^^^^     ^^^  ^^^
^^^ ^^^^^^^^  ^^^^^  ^    ^      ^ ^                    ^ ^  ^^^
^^^                # ^    ^  #   ^ ^^^^^^^^^^^^^^^^^    ^ ^  ^^^
^^^^^^^^^^^^^^^^^^^^^^    ^      ^      #              ^^ ^  ^^^
^^^                                                       ^  ^^^
^^^  ^^ ^^^ ^^^ ^^^^ ^^^^^^ ^^^^^^^^ ^^^^^^^^^^^^^^^^  ^  ^  ^^^
^^^  ^^ ^^    ^ ^      ^    ^           #              ^  ^  ^^^
^^^  ^^       ^ ^ ^^^^ ^    ^      ^                   ^  ^  ^^^
^^^  ^^^^^ ^^^^ ^^^  ^ ^^^^^^^^  ^^^^^^^^^^^^^^^^^^ ^^ ^  ^  ^^^
^^^  ^        ^   #     A  ^^^^      ^   ^   ^   ^     ^  ^  ^^^
^^^  ^ ^^^^^^^^              ^^  #     ^   ^   ^    ^  ^  ^  ^^^
^^^  ^      ^^^ ^^^^ ^^^^^^ ^^^^^^^^ ^^^^^^^^^^^^^^^^  ^  ^  ^^^
^^^  ^^ ^^    ^ ^      ^    ^   #                      ^  ^  ^^^
^^^           ^ ^ ^^^^ ^    ^      ^                      ^  ^^^
^^^  ^^ ^^^^^ ^ ^^^  ^ ^^^^^^^^ ^^^^^^^^^^^^^^^^^^^ ^^^   ^  ^^^
^^^  ^        ^      ^       ^^ ^^                      ^^^^^^^^
^^^  ^ ^^^^ ^^^      ^       ^^ ^^         ^ ^ ^ ^ ^ ^    ^  ^^^
^^^    ^^^   ^^^     ^           ^         ^ ^       ^   ^   ^^^
^^^    ^^     ^^     ^        ^^^^^^^^^^^^^^^^  ^    ^  ^    ^^^
^^^       #       #  ^        ^           ^^   ^     ^ ^     ^^^
^^^  ^^ ^^^^^^^^^^^^^^^^^^^^^^^  ^^  ^^^^^^^      ^ ^  ^ ^   ^^^
^^^   ^  ^         ^   ^    ^  ^ ^ ^  ^   ^   ^^ ^^  ^   ^   ^^^
^^^ ^^^^ ^ ^   ^   ^^ ^^    ^  ^ ^  ^ ^   ^    ^  ^  ^   ^   ^^^
^^^    ^   ^  ^^^                ^    ^    ^^^^^^^^^^^^^^    ^^^
^^^       #                                                  ^^^
^^^^^^^^^^^^^^^^^^^^^^^^^^^^^^^^^^^^^^^^^^^^^^^^^^^^^^^^^^^^^^^^
^^^^^^^^^^^^^^^^^^^^^^^^^^^^^^^^^^^^^^^^^^^^^^^^^^^^^^^^^^^^^^^^
^^^^^^^^^^^^^^^^^^^^^^^^^^^^^^^^^^^^^^^^^^^^^^^^^^^^^^^^^^^^^^^^