^^^^^^^^^^^^^^^^^^^^^^^^^^^^^^^^^^^^^^^^^^^^^^^^^^^^^^^^^^^^^^^
^^^^^^^^^^^^^^^^^^^^^^^^^^^^^^^^^^^^^^^^^^^^^^^^^^^^^^^^^^^^^^^
^^^^^^^^^^^^^^^^^^^^^^^^^^^^^^^^^^^^^^^^^^^^^^^^^^^^^^^^^^^^^^^
^^^                                                          ^^
^^^ ^^^^^^^^^^^^^^^^^^^^^^^^^ ^^^^^ ^^^^^ ^^^^^ ^^^^^^^^^^^^^^^
^^^ ^^^^^^^^^^^^^^^ ^^^^^^^ ^ ^   ^ ^   ^ ^   ^ ^            ^^
^^^ ^             ^ ^^^^^^^^^ ^   ^ ^   ^ ^   ^ ^            ^^
^^^ ^             ^ ^^^^^^^^^ ^   ^ ^   ^ ^   ^ ^            ^^
^^^ ^^^^^^^       ^ ^^^^^^^^^ ^   ^ ^   ^ ^   ^ ^            ^^
^^^       ^       ^ ^^^^^^^^^ ^^^^^ ^^^^^ ^^^^^ ^^^^^        ^^
^^^^^^^^^ ^       ^ ^  ^^^^^^ ^^^^^ ^^^^^ ^^^^^ ^^^^^        ^^
^^^       ^^^^^^^^^ ^  ^^^^^^ ^^^^^ ^^^^^ ^^^^^ ^^^^^        ^^
^^^ ^^^^^           ^  ^^^^^^ ^^^^^ ^^^^^ ^^^^^ ^^^^^        ^^
^^^ ^^^^^^^^^^^^^^^^^  ^^^^^^ ^^^^^ ^^^^^ ^^^^^ ^^^^^        ^^
^^^ ^^^^^ ^^^^^^^^^^^  ^^^^^^ ^^^^^ ^^^^^ ^^^^^ ^^^^^        ^^
^^^ ^^^^^ ^^^^^^^^^^^  ^^^^^^ ^^^^^ ^^^^^ ^^^^^ ^^^^^        ^^
^^^ ^^^^^                                                    ^^
^^^ ^^^^^ ^^^^^^^^^^^  ^^^^^^ ^^^^^ ^^^^^ ^^^^^ ^^^^^        ^^
^^^ ^^^^^ ^^^^^^^^^^^  ^^^^^^ ^^^^^ ^^^^^ ^^^^^ ^^^^^        ^^
^^^       ^^^^^^^^^^^  ^^^^^^ ^^^^^ ^^^^^ ^^^^^ ^^^^^        ^^
^^^ ^^^^^^^^^^^^^^^^^  ^^^^^^ ^^^^^ ^^^^^ ^^^^^ ^^^^^        ^^
^^^ ^^^^      ^^^^^^^       ^ ^^^^^ ^^^^^ ^^^^^ ^^^^^        ^^
^^^ ^^^^^^^^^ ^^^^^^^       ^ ^^^^^ ^^^^^ ^^^^^ ^^^^^        ^^
^^^ ^^^^^^^^^ ^^^^^^^       ^ ^^^^^ ^^^^^ ^^^^^ ^^^^^        ^^
^^^                 ^       ^ ^^^^^ ^^^^^ ^^^^^ ^^^^^        ^^
^^^ ^^^^^^^^^^^^^^^^^                                        ^^
^^^                                                          ^^
^^^                                                          ^^
^^^                                                          ^^
^^^^^^^^^^^^^^^^^^^^^^^^^^^^^^^^^^^^^^^^^^^^^^^^^^^^^^^^^^^^^^^
^^^^^^^^^^^^^^^^^^^^^^^^^^^^^^^^^^^^^^^^^^^^^^^^^^^^^^^^^^^^^^^
^^^^^^^^^^^^^^^^^^^^^^^^^^^^^^^^^^^^^^^^^^^^^^^^^^^^^^^^^^^^^^^