^^^^^^^^^^^^^^^^^^^^^^^^^^^^^^^^^^^^^^^^^^^^^^^^^^^^^^^^^^^^^^^^
^^^^^^^^^^^^^^^^^^^^^^^^^^^^^^^^^^^^^^^^^^^^^^^^^^^^^^^^^^^^^^^^
^^^^^^^^^^^^^^^^^^^^^^^^^^^^^^^^^^^^^^^^^^^^^^^^^^^^^^^^^^^^^^^^
^^^                                                          ^^^
^^^  ^^^^^^^  ^^^^^^^  ^^^^^^^^  ^^^^^  ^^^  ^^  ^^^^^^^^^^  ^^^
^^^  ^^^^^^^  ^^^^^^^  ^^^^^^^^  ^^^^^  ^^^  ^^  ^^^^^^^^^^  ^^^
^^^           ^^^^^^^  ^^^       ^^^^^  ^^^  ^^  ^^^^^^^^^^  ^^^
^^^  ^^^^^^^^^^^^^^^^  ^^^  ^^^  ^^^^^  ^^^  ^^  ^^^^^^^^^^  ^^^
^^^                         ^^^         ^^^                  ^^^
^^^  ^^^^  ^^^  ^^^^^^^^^^^^^^^  ^^^^^^^^^^^^^^  ^^^^^^^^^^  ^^^
^^^  ^^^^  ^^^  ^^^^        ^^^  ^^^^^^^         ^^^^^^^^^^  ^^^
^^^  ^^^^  ^^^  ^^^^  ^^^^  ^^^  ^^^^^^^  ^^^^^^^^^^^^^^^^^  ^^^
^^^  ^^^^       ^^^^  ^^^^                                   ^^^
^^^  ^^^^^^^^^        ^^^^  ^^^  ^^^^^  ^^^^^^^  ^^^^^^^^^^  ^^^
^^^  ^^^^^^^^^  ^^^^^^^^^^  ^^^  ^^^^^  ^^^^^^^  ^^^^^^^^^^  ^^^
^^^                             A                            ^^^
^^^  ^^^  ^^^^^^^  ^^^^^^  ^^^^  ^^^^^  ^^^^^^^  ^^^^^^^^^^  ^^^
^^^  ^^^      ^^^  ^^^^^^  ^^^^  ^^^^^  ^^^^^^^  ^^^^^^^^^^  ^^^
^^^  ^^^^^^^  ^^^  ^^^^^^        ^^^^^  ^^^^^^^  ^^^^^       ^^^
^^^           ^^^  ^^^^^^^^^^^^                         ^^^  ^^^
^^^  ^^^^^^^  ^^^  ^^^^^^^^^^^^  ^^^^^^^  ^^  ^^^^^^^^  ^^^  ^^^
^^^  ^^^^^^^           ^^^^^^^^  ^^^^^^^  ^^  ^^^^^^^^  ^^^  ^^^
^^^  ^^^^^^^^^^^^^^^^            ^^^^^^^  ^^  ^^^^^      ^^  ^^^
^^^                    ^^^^  ^^  ^^^^^^^  ^^  ^^^    ^^  ^^  ^^^
^^^  ^^^^^^^  ^^^^^^^^^^^^^  ^^                   ^^^^^  ^^  ^^^
^^^  ^^^^^^^      ^^^^^^^^^  ^^  ^^^^  ^^^^^^^  ^^^^^^^      ^^^
^^^  ^^^^^^^^^^^  ^^^^^^^    ^^  ^^^^  ^^^^^^^  ^^^^^^^  ^^  ^^^
^^^  ^^^^^^^^^^^  ^^^^^^^  ^^^^  ^^^^  ^^^^^^^  ^^^^^^^  ^^  ^^^
^^^                                                          ^^^
^^^^^^^^^^^^^^^^^^^^^^^^^^^^^^^^^^^^^^^^^^^^^^^^^^^^^^^^^^^^^^^^
^^^^^^^^^^^^^^^^^^^^^^^^^^^^^^^^^^^^^^^^^^^^^^^^^^^^^^^^^^^^^^^^
^^^^^^^^^^^^^^^^^^^^^^^^^^^^^^^^^^^^^^^^^^^^^^^^^^^^^^^^^^^^^^^^