^^^^^^^^^^^^^^^^^^^^^^^^^^^^^^^^^^^^^^^^^^^^^^^^^^^^^^^^^^^^^^^^
^^^^^^^^^^^^^^^^^^^^^^^^^^^^^^^^^^^^^^^^^^^^^^^^^^^^^^^^^^^^^^^^
^^^^^^^^^^^^^^^^^^^^^^^^^^^^^^^^^^^^^^^^^^^^^^^^^^^^^^^^^^^^^^^^
^^^     ^   ^                   ^               ^     ^      ^^^
^^^^^^^ ^ ^ ^^^^^^^ ^^^^^^^^^^^ ^^^^^^^ ^ ^^^^^^^^^^^ ^^^^^^ ^^^
^^^   ^   ^     ^   ^         ^         ^       ^       ^    ^^^
^^^ ^^^^^^^^^^^ ^ ^^^ ^^^^^ ^^^^^^^^^^^ ^ ^^^ ^^^^^ ^^^^^^^ ^^^^
^^^ ^     ^   ^ ^   ^     ^       ^   ^ ^   ^     ^       ^  ^^^
^^^ ^ ^^^ ^ ^ ^ ^ ^ ^^^^^ ^^^^^ ^ ^ ^ ^ ^ ^ ^^^^^ ^^^^^ ^ ^  ^^^
^^^         ^   ^ ^ ^ ^     ^   ^   ^   ^ ^ ^ ^     ^   ^ ^  ^^^
^^^ ^^^ ^^^^^^^^^^^ ^ ^ ^^^^^ ^^^^^^^^^^^^^ ^ ^ ^^^^^ ^^^^^  ^^^
^^^   ^   ^         ^   ^ ^   ^             ^   ^ ^   ^      ^^^
^^^ ^ ^^^ ^^^^^ ^^^^^^^ ^ ^ ^^^ ^^^^^^^ ^^^^^^^ ^ ^ ^^^ ^^^^ ^^^
^^^ ^   ^       ^     ^ ^ ^ ^   ^       ^     ^ ^ ^ ^   ^    ^^^
^^^^^ ^ ^^^^^^^^^^^ ^ ^ ^ ^ ^ ^^^ ^^^^^^^^^ ^ ^ ^ ^ ^ ^^^ ^  ^^^
^^^   ^ ^   ^ ^     ^ ^   ^ ^ ^   ^ ^ ^     ^ ^   ^ ^ ^   ^  ^^^
^^^ ^^^ ^ ^ ^ ^ ^ ^^^ ^^^^^ ^ ^ ^^^ ^ ^ ^ ^^^ ^^^^^ ^ ^ ^^^  ^^^
^^^ ^     ^ ^ ^ ^ ^             ^   ^ ^ ^ ^             ^    ^^^
^^^ ^^^^^^^ ^ ^ ^ ^^^^^^^ ^^^^^^^ ^^^ ^ ^ ^^^^^^^^^^^^^^^ ^  ^^^
^^^ ^   ^ ^ ^ ^ ^ ^             ^ ^ ^ ^ ^ ^             ^ ^  ^^^
^^^ ^ ^ ^ ^ ^ ^ ^ ^ ^^^^^^^ ^^^ ^ ^ ^ ^ ^ ^ ^^^^^^^ ^^^ ^ ^  ^^^
^^^   ^ ^   ^   ^ ^ ^ ^     ^   ^ ^ ^   ^ ^ ^ ^     ^   ^ ^  ^^^
^^^^^^^ ^ ^^^^^^^ ^ ^ ^ ^^^^^ ^^^ ^^^^^^^ ^ ^ ^ ^^^^^ ^^^ ^  ^^^
^^^     ^ ^     ^     ^   ^   ^   ^   ^     ^   ^   ^   ^    ^^^
^^^ ^^^^^ ^ ^^^ ^ ^^^^^^^ ^ ^^^ ^^^^^ ^ ^^^^^^^ ^ ^^^ ^^^ ^  ^^^
^^^ ^       ^   ^   ^     ^   ^ ^     ^   ^     ^   ^ ^   ^  ^^^
^^^ ^^^ ^^^^^ ^^^^^ ^ ^^^^^^^ ^ ^ ^ ^^^^^ ^ ^^^^^^^ ^ ^ ^ ^  ^^^
^^^ ^   ^           ^   ^   ^ ^   ^         ^   ^   ^ ^   ^  ^^^
^^^   ^^^ ^^^^^^^^^^^^^ ^^^ ^ ^^^^^^^^^^^^^^^^^   ^ ^ ^^^^^  ^^^
^^^^^^^^^^^^^^^^^^^^^^^^^^^^^^^^^^^^^^^^^^^^^^^^^^^^^^^^^^^^^^^^
^^^^^^^^^^^^^^^^^^^^^^^^^^^^^^^^^^^^^^^^^^^^^^^^^^^^^^^^^^^^^^^^
^^^^^^^^^^^^^^^^^^^^^^^^^^^^^^^^^^^^^^^^^^^^^^^^^^^^^^^^^^^^^^^^