^^^^^^^^^^^^^^^^^^^^^^^^^^^^^^^^^^^^^^^^^^^^^^^^^^^^^^^^^^^^^^^^
^^^^^^^^^^^^^^^^^^^^^^^^^^^^^^^^^^^^^^^^^^^^^^^^^^^^^^^^^^^^^^^^
^^^^^^^^^^^^^^^^^^^^^^^^^^^^^^^^^^^^^^^^^^^^^^^^^^^^^^^^^^^^^^^^
^^^     ^   ^                   ^                            ^^^
^^^^^^^ ^ ^ ^^^^^^^ ^^^^^^^^^^^ ^^^                          ^^^
^^^   ^   ^     ^   ^         ^                              ^^^
^^^ ^^^^^^^^^^^ ^ ^^^ ^^^^^ ^^^^^^^                          ^^^
^^^ ^     ^   ^ ^   ^     ^       ^                          ^^^
^^^ ^     ^ ^ ^ ^ ^ ^^^^^ ^^^^^ ^ ^                          ^^^
^^^ ^       ^   ^ ^ ^ ^     ^   ^ ^                          ^^^
^^^ ^^^ ^^^^^^^^^^^ ^ ^ ^^^^^ ^^^^^                          ^^^
^^^   ^   ^         ^   ^ ^   ^                              ^^^
^^^ ^ ^^^ ^^^^^ ^^^^^^^ ^ ^ ^^^ ^^^^                         ^^^
^^^ ^   ^       ^     ^ ^ ^ ^   ^                            ^^^
^^^^^ ^ ^^^^^^^^^^^ ^ ^ ^ ^ ^ ^^^ ^                          ^^^
^^^   ^ ^   ^ ^     ^ ^   ^ ^ ^   ^                          ^^^
^^^ ^^^ ^ ^ ^ ^ ^ ^^^ ^^^^^ ^ ^ ^^^                          ^^^
^^^ ^     ^ ^ ^ ^ ^         ^   ^                            ^^^
^^^ ^^^^^^^ ^ ^ ^ ^^^^^^^^^^^^^^^ ^^                         ^^^
^^^ ^   ^ ^ ^ ^ ^ ^             ^ ^                          ^^^
^^^ ^ ^ ^ ^ ^ ^ ^ ^ ^^^^^^^ ^^^ ^ ^                          ^^^
^^^   ^ ^   ^   ^ ^ ^ ^     ^   ^ ^                          ^^^
^^^^^^^ ^ ^^^^^^^ ^ ^ ^ ^^^^^ ^^^ ^                          ^^^
^^^     ^ ^     ^     ^   ^   ^   ^                          ^^^
^^^ ^^^^^ ^ ^^^ ^ ^^^^^^^ ^ ^^^ ^^^                          ^^^
^^^ ^   ^   ^   ^   ^     ^   ^ ^                            ^^^
^^^ ^^^ ^^^^^ ^^^^^ ^ ^^^^^^^ ^ ^ ^                          ^^^
^^^ ^   ^     ^     ^   ^   ^ ^   ^                          ^^^
^^^ ^ ^^^ ^^^^^^^^^^^^^ ^^^ ^ ^^^^^                          ^^^
^^^^^^^^^^^^^^^^^^^^^^^^^^^^^^^^^^^^^^^^^^^^^^^^^^^^^^^^^^^^^^^^
^^^^^^^^^^^^^^^^^^^^^^^^^^^^^^^^^^^^^^^^^^^^^^^^^^^^^^^^^^^^^^^^
^^^^^^^^^^^^^^^^^^^^^^^^^^^^^^^^^^^^^^^^^^^^^^^^^^^^^^^^^^^^^^^^